---........--.=------==.-..---==|
-...=====..-=-.....=-.-..-...--=|
-..-=...=..-=.-===.-..-...=...--|
-..-=.-.=..--.-.=....==-..==...-|
-..-=.===...=--==..=-...-.......|
-..........-=.=....=-.--==....==|
===.....=====-..--.....--==....-|
--..=......-===.-..=.-...---.===|
=..==....=......=..=..==.....-.-|
=.=-..==.===--=.......-.-===--.-|
=.....-....==--===.=..-..--...==|
---==...-=.....=.=.-.==-=====...|
-==......--.=-.....=..........--|
-.....--...=--====-=.....=....=.|
--..=========.---..==....=......|
....=...-......==...-...===.....|
.-.-=--...=.-.....-.-..=====....|
==.-=.-.--=.-.==..=-=.=======..=|
==..=======....-..=.=....=.....=|
............--.-...==-...=......|
==-..==...=...---=.-=...===..==-|
==--.==..-=...=..=..--.......=--|
|||||||||||||||||||||||||||||||||