...===.===..==.=.===....==......|
.=.=...=..=....=...=...=..==..=.|
.=.=.=......====.=.=.=.....=.=..|
==....===.=.=....=.=..=..===...=|
===.=.....=...===..=..=..===..==|
....==.===..=.==...===...===.=..|
.=..=..=...==..=.===.....===....|
.==.==...==.==...=..........=.=.|
.=....===...==....===.====.....=|
.=.=.=..=.==....=....===..=....=|
.==..==....=..==.....===...=..=.|
...=....==.=.........===....=...|
==.=====...=====.............=..|
.=..=....===....=...............|
.==...====.=.==.=..=............|
....=.=....=.==..=..............|
=.=.=...==...===...=.=..........|
.==.=.=====..===.==..=...===....|
..=...==....==.=..=..=.=....====|
=.======..===..=.==.=====.=....=|
=....=......=....=..=..==.===..=|
==.=...=.==...===..===.....=..==|
|||||||||||||||||||||||||||||||||